iphone 9	an apple mobile which is nothing like apple
iphone x	sim-free, model a19211 6.5-inch super retina hd display with oled technology a12 bionic chip with ...
samsung universe 9	samsung's new variant which goes beyond galaxy to the universe
oppof19	oppo f19 is officially announced on april 2021.
huawei p30	huawei’s re-badged p30 pro new edition was officially unveiled yesterday in germany and now the device has made its way to the uk.
macbook pro	macbook pro 2021 with mini-led display may launch between september, november
samsung galaxy book	samsung galaxy book s (2020) laptop with intel lakefield chip, 8gb of ram launched
microsoft surface laptop 4	style and speed. stand out on hd video calls backed by studio mics. capture ideas on the vibrant touchscreen.
infinix inbook	infinix inbook x1 ci3 10th 8gb 256gb 14 win10 grey – 1 year warranty
hp pavilion 15-dk1056wm	hp pavilion 15-dk1056wm gaming laptop 10th gen core i5, 8gb, 256gb ssd, gtx 1650 4gb, windows 10
perfume oil	mega discount, impression of acqua di gio by giorgioarmani concentrated attar perfume oil
brown perfume	royal_mirage sport brown perfume for men & women - 120ml
fog scent xpressio perfume	product details of best fog scent xpressio perfume 100ml for men cool long lasting perfumes for men
non-alcoholic concentrated perfume oil	original al munakh® by mahal al musk | our impression of climate | 6ml non-alcoholic concentrated perfume oil
eau de perfume spray	genuine  al-rehab spray perfume from uae/saudi arabia/yemen high quality
hyaluronic acid serum	l'orã©al paris introduces hyaluron expert replumping serum formulated with 1.5% hyaluronic acid
tree oil 30ml	tea tree oil contains a number of compounds, including terpinen-4-ol, that have been shown to kill certain bacteria,
oil free moisturizer 100ml	dermive oil free moisturizer with spf 20 is specifically formulated with ceramides, hyaluronic acid & sunscreen.
skin beauty serum.	product name: rorec collagen hyaluronic acid white face serum ricenet weight: 15 m
freckle treatment cream- 15gm	fair & clear is pakistan's only pure freckle cream which helpsfade freckles, darkspots and pigments. mercury level is 0%, so there are no side effects.
- daal masoor 500 grams	fine quality branded product keep in a cool and dry place
elbow macaroni - 400 gm	product details of bake parlor big elbow macaroni - 400 gm
orange essence food flavou	specifications of orange essence food flavour for cakes and baking food item
cereals muesli fruit nuts	original fauji cereal muesli 250gm box pack original fauji cereals muesli fruit nuts flakes breakfast cereal break fast faujicereals cerels cerel foji fouji
gulab powder 50 gram	dry rose flower powder gulab powder 50 gram • treats wounds
plant hanger for home	boho decor plant hanger for home wall decoration macrame wall hanging shelf
flying wooden bird	package include 6 birds with adhesive tape shape: 3d shaped wooden birds material: wooden mdf, laminated 3.5mm
3d embellishment art lamp	3d led lamp sticker wall sticker 3d wall art light on/off button  cell operated (included)
handcraft chinese style	handcraft chinese style art luxury palace hotel villa mansion home decor ceramic vase with brass fruit plate
key holder	attractive designmetallic materialfour key hooksreliable & durablepremium quality
mornadi velvet bed	mornadi velvet bed base with headboard slats support classic style bedroom furniture bed set
sofa for coffe cafe	ratttan outdoor furniture set waterproof  rattan sofa for coffe cafe
3 tier corner shelves	3 tier corner shelves | 3 pcs wall mount kitchen shelf | floating bedroom shelf
plastic table	v?ery good quality plastic table for multi purpose now in reasonable price
3 door portable	material: stainless steel and fabric  item size: 110 cm x 45 cm x 175 cm package contents: 1 storage wardrobe
sleeve shirt womens	cotton solid color professional wear sleeve shirt womens work blouses wholesale clothing casual plain custom top oem customized
ank tops for womens/girls	pack of 3 camisoles ,very comfortable soft cotton stuff, comfortable in all four seasons
sublimation plain kids tank	sublimation plain kids tank tops wholesale
women sweaters wool	2021 custom winter fall zebra knit crop top women sweaters wool mohair cos customize crew neck women' s crop top sweater
women winter clothes	women winter clothes thick fleece hoodie top with sweat pantjogger women sweatsuit set joggers pants two piece pants set
night suit	night suit red micky mouse..  for girls. fantastic suits.
stiched kurta plus trouser	fabric: lilein chest: 21 lenght: 37 trouser: (38) :arabic lilein
frock gold printed	ghazi fabric long frock gold printed ready to wear stitched collection (g992)
ladies multicolored dress	this classy shirt for women gives you a gorgeous look on everyday wear and specially for semi-casual wears.
malai maxi dress	ready to wear, unique design according to modern standard fashion, best fitting ,imported stuff
women's shoes	close: lace, style with bottom: increased inside, sole material: rubber
sneaker shoes	synthetic leather casual sneaker shoes for women/girls sneakers for women
women strip heel	features: flip-flops, mid heel, comfortable, striped heel, antiskid, striped
chappals & shoe ladies metallic	womens chappals & shoe ladies metallic tong thong sandal flat summer 2020 maasai sandals
women shoes	2020 new arrivals genuine leather fashion trend platform summer women shoes
half sleeves t shirts	many store is creating new designs and trend every month and every year. daraz.pk have a beautiful range of men fashion brands
free fire t shirt	quality and professional print - it doesn't just look high quality, it is high quality.
printed high quality t shirts	brand: vintage apparel ,export quality
pubg printed graphic t-shirt	product description features: 100% ultra soft polyester jersey. vibrant & colorful printing on front. feels soft as cotton without ever cracking
money heist printed summer t shirts	fabric jercy, size: m & l wear stylish dual stiched
sneakers joggers shoes	gender: men , colors: same as displayedcondition: 100% brand new
loafers for men	men shoes - loafers for men - rubber shoes - nylon shoes - shoes for men - moccassion - pure nylon (rubber) expot quality.
formal offices shoes	pattern type: solid, material: pu, toe shape: pointed toe ,outsole material: rubber
spring and summershoes	comfortable stretch cloth, lightweight body; ,rubber sole, anti-skid wear;
stylish casual jeans shoes	high quality ,stylish design ,comfortable wear ,fashion ,durable
leather straps wristwatch	style:sport ,clasp:buckles ,water resistance depth:3bar
waterproof leather brand watch	watch crown with environmental ips bronze electroplating; display system of 12 hours
royal blue premium watch	men silver chain royal blue premium watch latest analog watch
leather strap skeleton watch	leather strap skeleton watch for men - stylish and latest design
stainless steel wrist watch	stylish watch for man (luxury) classy men's stainless steel wrist watch - box packed
steel analog couple watches	elegant design, stylish ,unique & trendy,comfortable wear
fashion magnetic wrist watch	buy this awesome  the product is originally manufactured by the company and it's a top selling product with a very reasonable
stylish luxury digital watch	stylish luxury digital watch for girls / women - led smart ladies watches for girls
golden watch pearls bracelet watch	product details of golden watch pearls bracelet watch for girls - golden chain ladies bracelate watch for women
stainless steel women	fashion skmei 1830 shell dial stainless steel women wrist watch lady bracelet watch quartz watches ladies
women shoulder bags	louiswill women shoulder bags long clutches cross body bags phone bags pu leather hand bags large capacity card holders zipper coin purses fashion crossbody bags for girls ladies
handbag for girls	this fashion is designed to add a charming effect to your casual outfit. this bag is made of synthetic leather.
fancy hand clutch	this fashion is designed to add a charming effect to your casual outfit. this bag is made of synthetic leather.
leather hand bag	it features an attractive design that makes it a must have accessory in your collection. we sell different kind of bags for boys, kids, women, girls and also for unisex.
seven pocket women bag	seven pocket women bag handbags lady shoulder crossbody bag female purse seven pocket bag
silver ring set women	jewelry type:ringscertificate type:noneplating:silver platedshapeattern:nonestyle:classicreligious
rose ring	brand: the greetings flower colour: redring colour: goldensize: adjustable
rhinestone korean style open rings	fashion jewellery 3pcs adjustable pearl rhinestone korean style open rings for women
elegant female pearl earrings	elegant female pearl earrings set zircon pearl earings women party accessories 9 pairs/set
chain pin tassel earrings	pair of ear cuff butterfly long chain pin tassel earrings - silver ( long life quality product)
